########################################
#     ######         ##            #####
####O #####   #####      ########     ##
####     ####    ##   O ############  ##
###   ######## O ####                 ##
##O              ############    #######
#############  ######  ######         O#
###     #####   ####       ########    #
######        ######    O   #####     ##
################      O ##           ###
#####    #####    ###        ###########
###    ####      ####   ###         ####
##   ######  ########   ###     ########
##           ####O     ###   ##      ###
#     ###################    ######   ##
##          O ####     ##  O  ##########
##   ######         ######  ########   #
#    #####################  #######    #
# O                     ##             #
######    ###########  #################
####      ###   #####  ### O ###########
#######   ###O                     #####
#              ##      #######   ####  #
######  #########         ###          #
#O        ############  ########   #####
#   #############   #########O        ##
#  ####     O               ###    #####
#  ########   ############  ############
#                       ##            H#
########################################
